NO ./temp/wood.xpm
SO ./temp/stone.xpm
WE ./temp/sand.xpm
EA ./temp/grass.xpm

F 148,195,99
C 200,220,200

1111111111111111111111111111111111111111
1E00000000000000000000000000000000000001
1011111111101111011111101111111111011101
1000100000100010000010000001000001000001
1010111110101111111010111010101011011101
1000100000000001000001000001000000000001
1011111110101111101011111111011111011101
1000000000100000000000000000000010000001
1011111110001111101001111111011011111101
1000100000100001000000000001000001000001
1010111110101111111000111010101011101001
1000000000000000000010000001000001000001
1011111111101111111011111111010111101101
1000000000000000000010000001000000000001
1111111111111111111111111111111111111111